#####################################################
##### THE GRID SHOULD BE 9 ROWS x 7 COLUMNS MAX #####
##### THE LEVEL FILE SHOULD ONLY CONTAINS CHARS #####
#####################################################

@BEGIN
0,0,0,0,0,0,0
0,0,0,0,0,0,0
0,0,1,1,1,0,0
0,0,0,x,1,0,0
0,0,1,0,1,0,0
@END

######################################################
###### WRITE EVERYTHING BETWEEN @BEGIN AND @END ######
######################################################